{ "map" : [
0,2,3,3,3,3,3,4,0,0,0,0,0,0,0,
0,0,6,0,0,0,0,5,0,0,0,0,0,0,0,
0,0,0,6,0,0,0,2,3,3,3,3,3,3,4,
0,0,0,8,6,0,0,0,0,0,5,0,0,0,0,
0,0,0,0,1,6,0,8,0,0,5,0,0,0,0,
0,0,5,0,0,7,6,2,3,3,3,3,4,0,6,
0,0,7,1,0,0,7,0,0,0,0,0,5,0,1,
0,6,0,0,1,0,0,0,0,0,0,8,5,0,0,
6,1,1,0,0,0,9,2,4,0,0,0,5,0,0,
1,1,1,1,1,1,1,3,3,3,3,1,1,1,1
]
}