{ "map" : [
1,1,1,1,1,1,1,1,1,1,1,1,1,1,1,
1,0,1,1,1,0,0,0,0,0,1,1,0,0,1,
1,1,1,0,1,2,3,3,3,4,0,1,1,0,1,
1,1,0,1,1,5,0,0,0,0,0,1,1,1,1,
1,1,1,9,1,5,0,1,8,0,0,0,0,1,1,
0,1,1,0,0,5,0,1,0,0,0,0,0,1,1,
0,1,0,0,0,5,6,1,6,0,0,0,0,0,1,
1,1,0,1,1,3,1,1,1,1,1,0,0,1,1,
0,1,0,0,0,0,0,0,0,0,0,0,0,1,1,
1,1,1,1,1,1,0,1,0,1,1,1,1,1,1
]
}